"filename", "language", "CSS", "HTML", "JavaScript", "comment", "blank", "total"
"d:\Users\taketo\Documents\10_GitPages\heibei2020.github.io\backyard\WikipediaAPI01.html", "HTML", 0, 63, 0, 1, 16, 80
"d:\Users\taketo\Documents\10_GitPages\heibei2020.github.io\backyard\animation01.html", "HTML", 0, 47, 0, 1, 12, 60
"d:\Users\taketo\Documents\10_GitPages\heibei2020.github.io\backyard\animation02.html", "HTML", 0, 75, 0, 1, 16, 92
"d:\Users\taketo\Documents\10_GitPages\heibei2020.github.io\backyard\animation_style.css", "CSS", 26, 0, 0, 10, 2, 38
"d:\Users\taketo\Documents\10_GitPages\heibei2020.github.io\backyard\cache.html", "HTML", 0, 68, 0, 1, 16, 85
"d:\Users\taketo\Documents\10_GitPages\heibei2020.github.io\backyard\chaindisplay01.html", "HTML", 0, 65, 0, 1, 15, 81
"d:\Users\taketo\Documents\10_GitPages\heibei2020.github.io\backyard\chaindisplay02.html", "HTML", 0, 106, 0, 1, 23, 130
"d:\Users\taketo\Documents\10_GitPages\heibei2020.github.io\backyard\chaindisplay03.html", "HTML", 0, 142, 0, 1, 33, 176
"d:\Users\taketo\Documents\10_GitPages\heibei2020.github.io\backyard\chaindisplay04.html", "HTML", 0, 205, 0, 1, 48, 254
"d:\Users\taketo\Documents\10_GitPages\heibei2020.github.io\backyard\chaindisplay05.html", "HTML", 0, 197, 0, 1, 52, 250
"d:\Users\taketo\Documents\10_GitPages\heibei2020.github.io\backyard\display_style.css", "CSS", 42, 0, 0, 0, 4, 46
"d:\Users\taketo\Documents\10_GitPages\heibei2020.github.io\backyard\display_style2.css", "CSS", 42, 0, 0, 0, 4, 46
"d:\Users\taketo\Documents\10_GitPages\heibei2020.github.io\backyard\kuromoji.js", "JavaScript", 0, 0, 4007, 4208, 845, 9060
"d:\Users\taketo\Documents\10_GitPages\heibei2020.github.io\backyard\wikipediaAPI02.html", "HTML", 0, 95, 0, 1, 17, 113
"Total", "-", 110, 1063, 4007, 4228, 1103, 10511